[header]
width=16
height=12

[layer]
type=background
data=
33,34,35,15,15,33,34,35,38,48,47,48,47,48,47,48,
33,34,35,15,15,33,34,35,39,31,32,31,32,31,32,31,
33,34,35,15,15,33,34,35,38,39,38,39,38,39,38,39,
33,34,35,15,15,33,34,44,26,26,26,26,26,26,26,26,
33,34,35,15,15,33,34,34,34,34,34,34,34,34,34,34,
33,34,35,15,15,41,42,42,42,42,42,42,42,42,42,42,
33,34,35,15,15,15,15,15,15,15,15,15,15,15,15,15,
33,34,35,15,15,15,15,15,15,15,15,15,15,15,15,15,
33,34,44,26,26,26,26,26,26,26,26,26,26,26,26,26,
33,34,34,34,34,34,34,34,34,34,34,34,34,34,34,34,
41,42,42,42,42,42,42,42,42,42,42,42,42,42,42,42,
38,40,38,40,38,40,38,40,38,40,38,40,38,40,38,40

[layer]
type=collision
data=
0,2,0,1,1,0,2,0,0,0,0,0,0,0,0,0,
0,2,0,1,1,0,2,0,0,0,0,0,0,0,0,0,
0,2,0,1,1,0,2,0,0,0,0,0,0,0,0,0,
0,2,0,1,1,0,2,0,0,0,0,0,0,0,0,0,
0,2,0,1,1,0,2,2,2,2,2,2,2,2,2,2,
0,2,0,1,1,0,0,0,0,0,0,0,0,0,0,0,
0,2,0,1,1,1,1,1,1,1,1,1,1,1,1,1,
0,2,0,1,1,1,1,1,1,1,1,1,1,1,1,1,
0,2,0,0,0,0,0,0,0,0,0,0,0,0,0,0,
0,2,2,2,2,2,2,2,2,2,2,2,2,2,2,2,
0,0,0,0,0,0,0,0,0,0,0,0,0,0,0,0,
0,0,0,0,0,0,0,0,0,0,0,0,0,0,0,0