[header]
width=18
height=18

[layer]
type=background
data=
34,34,34,34,34,34,34,34,34,34,34,34,34,34,34,34,34,34,
34,30,30,30,30,30,30,30,30,30,30,30,30,30,30,30,30,34,
34,30,31,31,31,31,31,31,31,31,31,31,31,31,31,31,30,34,
34,30,31,38,38,38,38,38,38,38,38,38,38,38,38,31,30,34,
34,30,31,38,47,47,47,47,47,47,47,47,47,47,38,31,30,34,
34,30,31,38,47,32,32,32,32,32,32,32,32,47,38,31,30,34,
34,30,31,38,47,32,46,46,46,46,46,46,32,47,38,31,30,34,
34,30,31,38,47,32,46,39,39,39,39,46,32,47,38,31,30,34,
34,30,31,38,47,32,46,39,40,40,39,46,32,47,38,31,30,34,
34,30,31,38,47,32,46,39,40,40,39,46,32,47,38,31,30,34,
34,30,31,38,47,32,46,39,39,39,39,46,32,47,38,31,30,34,
34,30,31,38,47,32,46,46,46,46,46,46,32,47,38,31,30,34,
34,30,31,38,47,32,32,32,32,32,32,32,32,47,38,31,30,34,
34,30,31,38,47,47,47,47,47,47,47,47,47,47,38,31,30,34,
34,30,31,38,38,38,38,38,38,38,38,38,38,38,38,31,30,34,
34,30,31,31,31,31,31,31,31,31,31,31,31,31,31,31,30,34,
34,30,30,30,30,30,30,30,30,30,30,30,30,30,30,30,30,34,
34,34,34,34,34,34,34,34,34,34,34,34,34,34,34,34,34,34

[layer]
type=collision
data=
0,0,0,0,0,0,0,0,0,0,0,0,0,0,0,0,0,0,
0,0,0,0,0,0,0,0,0,0,0,0,0,0,0,0,0,0,
0,0,0,0,0,0,0,0,0,0,0,0,0,0,0,0,0,0,
0,0,0,0,0,0,0,0,0,0,0,0,0,0,0,0,0,0,
0,0,0,0,0,0,0,0,0,0,0,0,0,0,0,0,0,0,
0,0,0,0,0,0,0,0,0,0,0,0,0,0,0,0,0,0,
0,0,0,0,0,0,0,0,0,0,0,0,0,0,0,0,0,0,
0,0,0,0,0,0,0,0,0,0,0,0,0,0,0,0,0,0,
0,0,0,0,0,0,0,0,0,0,0,0,0,0,0,0,0,0,
0,0,0,0,0,0,0,0,0,0,0,0,0,0,0,0,0,0,
0,0,0,0,0,0,0,0,0,0,0,0,0,0,0,0,0,0,
0,0,0,0,0,0,0,0,0,0,0,0,0,0,0,0,0,0,
0,0,0,0,0,0,0,0,0,0,0,0,0,0,0,0,0,0,
0,0,0,0,0,0,0,0,0,0,0,0,0,0,0,0,0,0,
0,0,0,0,0,0,0,0,0,0,0,0,0,0,0,0,0,0,
0,0,0,0,0,0,0,0,0,0,0,0,0,0,0,0,0,0,
0,0,0,0,0,0,0,0,0,0,0,0,0,0,0,0,0,0,
0,0,0,0,0,0,0,0,0,0,0,0,0,0,0,0,0,0

